GRTE_SELF_SERVICE___SEQUOIA_BVT_10_BUILD_NUMBER	16439
GRTE_SELF_SERVICE___SEQUOIA_BVT_10_BUILD_RESULT	SUCCESS
GRTE_SELF_SERVICE___SEQUOIA_BVT_11_BUILD_NUMBER	16442
GRTE_SELF_SERVICE___SEQUOIA_BVT_11_BUILD_RESULT	SUCCESS
GRTE_SELF_SERVICE___SEQUOIA_BVT_12_BUILD_NUMBER	16425
GRTE_SELF_SERVICE___SEQUOIA_BVT_12_BUILD_RESULT	SUCCESS
GRTE_SELF_SERVICE___SEQUOIA_BVT_13_BUILD_NUMBER	16422
GRTE_SELF_SERVICE___SEQUOIA_BVT_13_BUILD_RESULT	UNSTABLE
GRTE_SELF_SERVICE___SEQUOIA_BVT_14_BUILD_NUMBER	16430
GRTE_SELF_SERVICE___SEQUOIA_BVT_14_BUILD_RESULT	UNSTABLE
GRTE_SELF_SERVICE___SEQUOIA_BVT_15_BUILD_NUMBER	16414
GRTE_SELF_SERVICE___SEQUOIA_BVT_15_BUILD_RESULT	SUCCESS
GRTE_SELF_SERVICE___SEQUOIA_BVT_16_BUILD_NUMBER	16432
GRTE_SELF_SERVICE___SEQUOIA_BVT_16_BUILD_RESULT	SUCCESS
GRTE_SELF_SERVICE___SEQUOIA_BVT_17_BUILD_NUMBER	16456
GRTE_SELF_SERVICE___SEQUOIA_BVT_17_BUILD_RESULT	SUCCESS
GRTE_SELF_SERVICE___SEQUOIA_BVT_18_BUILD_NUMBER	16441
GRTE_SELF_SERVICE___SEQUOIA_BVT_18_BUILD_RESULT	SUCCESS
GRTE_SELF_SERVICE___SEQUOIA_BVT_19_BUILD_NUMBER	16423
GRTE_SELF_SERVICE___SEQUOIA_BVT_19_BUILD_RESULT	SUCCESS
GRTE_SELF_SERVICE___SEQUOIA_BVT_1_BUILD_NUMBER	16420
GRTE_SELF_SERVICE___SEQUOIA_BVT_1_BUILD_RESULT	SUCCESS
GRTE_SELF_SERVICE___SEQUOIA_BVT_20_BUILD_NUMBER	16428
GRTE_SELF_SERVICE___SEQUOIA_BVT_20_BUILD_RESULT	SUCCESS
GRTE_SELF_SERVICE___SEQUOIA_BVT_21_BUILD_NUMBER	16431
GRTE_SELF_SERVICE___SEQUOIA_BVT_21_BUILD_RESULT	SUCCESS
GRTE_SELF_SERVICE___SEQUOIA_BVT_22_BUILD_NUMBER	16433
GRTE_SELF_SERVICE___SEQUOIA_BVT_22_BUILD_RESULT	SUCCESS
GRTE_SELF_SERVICE___SEQUOIA_BVT_23_BUILD_NUMBER	16416
GRTE_SELF_SERVICE___SEQUOIA_BVT_23_BUILD_RESULT	SUCCESS
GRTE_SELF_SERVICE___SEQUOIA_BVT_24_BUILD_NUMBER	16437
GRTE_SELF_SERVICE___SEQUOIA_BVT_24_BUILD_RESULT	UNSTABLE
GRTE_SELF_SERVICE___SEQUOIA_BVT_25_BUILD_NUMBER	16450
GRTE_SELF_SERVICE___SEQUOIA_BVT_25_BUILD_RESULT	SUCCESS
GRTE_SELF_SERVICE___SEQUOIA_BVT_26_BUILD_NUMBER	16449
GRTE_SELF_SERVICE___SEQUOIA_BVT_26_BUILD_RESULT	SUCCESS
GRTE_SELF_SERVICE___SEQUOIA_BVT_27_BUILD_NUMBER	16436
GRTE_SELF_SERVICE___SEQUOIA_BVT_27_BUILD_RESULT	SUCCESS
GRTE_SELF_SERVICE___SEQUOIA_BVT_28_BUILD_NUMBER	16417
GRTE_SELF_SERVICE___SEQUOIA_BVT_28_BUILD_RESULT	SUCCESS
GRTE_SELF_SERVICE___SEQUOIA_BVT_29_BUILD_NUMBER	16451
GRTE_SELF_SERVICE___SEQUOIA_BVT_29_BUILD_RESULT	SUCCESS
GRTE_SELF_SERVICE___SEQUOIA_BVT_2_BUILD_NUMBER	16415
GRTE_SELF_SERVICE___SEQUOIA_BVT_2_BUILD_RESULT	SUCCESS
GRTE_SELF_SERVICE___SEQUOIA_BVT_30_BUILD_NUMBER	16453
GRTE_SELF_SERVICE___SEQUOIA_BVT_30_BUILD_RESULT	SUCCESS
GRTE_SELF_SERVICE___SEQUOIA_BVT_31_BUILD_NUMBER	16421
GRTE_SELF_SERVICE___SEQUOIA_BVT_31_BUILD_RESULT	SUCCESS
GRTE_SELF_SERVICE___SEQUOIA_BVT_32_BUILD_NUMBER	16424
GRTE_SELF_SERVICE___SEQUOIA_BVT_32_BUILD_RESULT	SUCCESS
GRTE_SELF_SERVICE___SEQUOIA_BVT_33_BUILD_NUMBER	16440
GRTE_SELF_SERVICE___SEQUOIA_BVT_33_BUILD_RESULT	SUCCESS
GRTE_SELF_SERVICE___SEQUOIA_BVT_34_BUILD_NUMBER	16447
GRTE_SELF_SERVICE___SEQUOIA_BVT_34_BUILD_RESULT	SUCCESS
GRTE_SELF_SERVICE___SEQUOIA_BVT_35_BUILD_NUMBER	16413
GRTE_SELF_SERVICE___SEQUOIA_BVT_35_BUILD_RESULT	SUCCESS
GRTE_SELF_SERVICE___SEQUOIA_BVT_36_BUILD_NUMBER	16443
GRTE_SELF_SERVICE___SEQUOIA_BVT_36_BUILD_RESULT	SUCCESS
GRTE_SELF_SERVICE___SEQUOIA_BVT_37_BUILD_NUMBER	16444
GRTE_SELF_SERVICE___SEQUOIA_BVT_37_BUILD_RESULT	SUCCESS
GRTE_SELF_SERVICE___SEQUOIA_BVT_38_BUILD_NUMBER	16448
GRTE_SELF_SERVICE___SEQUOIA_BVT_38_BUILD_RESULT	SUCCESS
GRTE_SELF_SERVICE___SEQUOIA_BVT_39_BUILD_NUMBER	16452
GRTE_SELF_SERVICE___SEQUOIA_BVT_39_BUILD_RESULT	SUCCESS
GRTE_SELF_SERVICE___SEQUOIA_BVT_3_BUILD_NUMBER	16419
GRTE_SELF_SERVICE___SEQUOIA_BVT_3_BUILD_RESULT	SUCCESS
GRTE_SELF_SERVICE___SEQUOIA_BVT_40_BUILD_NUMBER	16446
GRTE_SELF_SERVICE___SEQUOIA_BVT_40_BUILD_RESULT	SUCCESS
GRTE_SELF_SERVICE___SEQUOIA_BVT_41_BUILD_NUMBER	16455
GRTE_SELF_SERVICE___SEQUOIA_BVT_41_BUILD_RESULT	UNSTABLE
GRTE_SELF_SERVICE___SEQUOIA_BVT_42_BUILD_NUMBER	16457
GRTE_SELF_SERVICE___SEQUOIA_BVT_42_BUILD_RESULT	UNSTABLE
GRTE_SELF_SERVICE___SEQUOIA_BVT_43_BUILD_NUMBER	16434
GRTE_SELF_SERVICE___SEQUOIA_BVT_43_BUILD_RESULT	SUCCESS
GRTE_SELF_SERVICE___SEQUOIA_BVT_4_BUILD_NUMBER	16435
GRTE_SELF_SERVICE___SEQUOIA_BVT_4_BUILD_RESULT	SUCCESS
GRTE_SELF_SERVICE___SEQUOIA_BVT_5_BUILD_NUMBER	16438
GRTE_SELF_SERVICE___SEQUOIA_BVT_5_BUILD_RESULT	SUCCESS
GRTE_SELF_SERVICE___SEQUOIA_BVT_6_BUILD_NUMBER	16429
GRTE_SELF_SERVICE___SEQUOIA_BVT_6_BUILD_RESULT	SUCCESS
GRTE_SELF_SERVICE___SEQUOIA_BVT_7_BUILD_NUMBER	16426
GRTE_SELF_SERVICE___SEQUOIA_BVT_7_BUILD_RESULT	SUCCESS
GRTE_SELF_SERVICE___SEQUOIA_BVT_8_BUILD_NUMBER	16454
GRTE_SELF_SERVICE___SEQUOIA_BVT_8_BUILD_RESULT	SUCCESS
GRTE_SELF_SERVICE___SEQUOIA_BVT_9_BUILD_NUMBER	16445
GRTE_SELF_SERVICE___SEQUOIA_BVT_9_BUILD_RESULT	SUCCESS
GRTE_SELF_SERVICE___SEQUOIA_BVT_BUILD_NAME	SEQ-LLND2-REG-OfflineA-1.tests
GRTE_SELF_SERVICE___SEQUOIA_BVT_BUILD_NUMBER	16434
GRTE_SELF_SERVICE___SEQUOIA_BVT_BUILD_RESULT	SUCCESS
LAST_TRIGGERED_JOB_NAME	GRTE Self Service - Sequoia BVT
MULTIJOB_ABORTED	0
MULTIJOB_FAILED	0
MULTIJOB_SKIPPED	0
MULTIJOB_STABLE	40
MULTIJOB_SUCCESSFUL	45
MULTIJOB_UNSTABLE	5
PHASE_ABORTED	0
PHASE_FAILED	0
PHASE_RESULT	UNSTABLE
PHASE_SKIPPED	0
PHASE_STABLE	40
PHASE_SUCCESSFUL	45
PHASE_UNSTABLE	5
SELF_SERVICE_ACCEPTANCE_ABORTED	0
SELF_SERVICE_ACCEPTANCE_FAILED	0
SELF_SERVICE_ACCEPTANCE_RESULT	UNSTABLE
SELF_SERVICE_ACCEPTANCE_SKIPPED	0
SELF_SERVICE_ACCEPTANCE_STABLE	40
SELF_SERVICE_ACCEPTANCE_SUCCESSFUL	45
SELF_SERVICE_ACCEPTANCE_UNSTABLE	5
TRIGGERED_BUILD_RUN_COUNT_GRTE_SELF_SERVICE___SEQUOIA_BVT	43
TRIGGERED_JOB_NAMES	GRTE Self Service - Sequoia BVT,GRTE Self Service - Sequoia BVT,GRTE Self Service - Sequoia BVT,GRTE Self Service - Sequoia BVT,GRTE Self Service - Sequoia BVT,GRTE Self Service - Sequoia BVT,GRTE Self Service - Sequoia BVT,GRTE Self Service - Sequoia BVT,GRTE Self Service - Sequoia BVT,GRTE Self Service - Sequoia BVT,GRTE Self Service - Sequoia BVT,GRTE Self Service - Sequoia BVT,GRTE Self Service - Sequoia BVT,GRTE Self Service - Sequoia BVT,GRTE Self Service - Sequoia BVT,GRTE Self Service - Sequoia BVT,GRTE Self Service - Sequoia BVT,GRTE Self Service - Sequoia BVT,GRTE Self Service - Sequoia BVT,GRTE Self Service - Sequoia BVT,GRTE Self Service - Sequoia BVT,GRTE Self Service - Sequoia BVT,GRTE Self Service - Sequoia BVT,GRTE Self Service - Sequoia BVT,GRTE Self Service - Sequoia BVT,GRTE Self Service - Sequoia BVT,GRTE Self Service - Sequoia BVT,GRTE Self Service - Sequoia BVT,GRTE Self Service - Sequoia BVT,GRTE Self Service - Sequoia BVT,GRTE Self Service - Sequoia BVT,GRTE Self Service - Sequoia BVT,GRTE Self Service - Sequoia BVT,GRTE Self Service - Sequoia BVT,GRTE Self Service - Sequoia BVT,GRTE Self Service - Sequoia BVT,GRTE Self Service - Sequoia BVT,GRTE Self Service - Sequoia BVT,GRTE Self Service - Sequoia BVT,GRTE Self Service - Sequoia BVT,GRTE Self Service - Sequoia BVT,GRTE Self Service - Sequoia BVT,GRTE Self Service - Sequoia BVT